English Text	Russian Grammar	
The only people who never fail are those who never try.	[Никогда, Ни разу] не [ошибается, совершает ошибок] тот, кто [ничего не делает, бездействует].	subject
Failure is just another way to learn how to do something right.	[Bзрослеть, Учиться] на ошибках.	subject
I failed my way to success.	[Свой путь, Свою дорогу] к [успеху, удаче] я [нашел, однаружил] благодаря ошибкам.	subject
Every failure brings with it the seed of an equivalent success.	[В каждой, В любой, Во всякой] [беде, неудаче], кроме проблемы, есть зачаток равной а [иногда, в некоторых случаях, временами, порой] и большей пользы.	subject
Only those who dare to fail greatly can ever achieve greatly.	[Только, Лишь] те, кто [осмеливаются, готовы] потерпеть [серьёзную, крупную] неудачу, могут [достичь, добиться] [больших, значительных, существенных] успехов.	subject
It is hard to fail, but it is worse never to have tried to succeed.	[Тяжело, Тяжко] [терпеть, испытывать, осознавать свою, ощущать свою] неудачу, но [ещё, куда, гораздо, во много раз, значительно] хуже [никогда, вообще никогда] не [пытаться, пробовать, предпринимать попыток] [добиться успеха,  стремиться к успеху, добиться своей цели, стремиться к своей цели, идти к своему успеху,  идти к своей цели].	subject
Imagination is more important than knowledge.	[Надежда, Bоображение]  [сильнее, важнее, значимее] знания.	subject
Hold fast to dreams, for if dreams die, life is a broken winged bird that cannot fly.	[Крепко держитесь, Упорно держитесь] за [мечту, свою мечту, свою цель], ведь когда она [умирает, погибает], жизнь становиться подобна [сломавшей крыло птице, птице со сломанным крылом] [которая не может, неспособной] летать.	subject
The future belongs to those who believe in the beauty of their dreams.	[Война, Эта тема, Эта война, Война в Украине], [касается всех, затрагивает всех, касается каждого, затрагивает каждого, общее дело каждого, касается всех нас, затрагивает всех нас].	subject
Go confidently in the direction of your dreams. Live the life you have imagined.	[Гордо, Уверенно, Решительно, Без колебаний] следуй за своими [целями, мечтами]. [Действуй, Живи] так, [как хочется тебе, по своим правилам, как ты пожелаешь, тебе того хочется].	subject
You cannot depend on your eyes when your imagination is out of focus.	Вы не можете [доверять своим глазам, полагаться на свои глаза], когда [ваш разум рассеян, ваше воображение не сосредоточено, ваш разум в тумане, ваше воображение в тумане].	subject
[Return, Put away, Bring back] thy sword back, [for, as] all who [bring forth, take out] their sword, [with the sword, by it] [will perish, meet their death].	[Возврати, Отложи, Верни] меч твой обратно, [ибо, так как] все, [взявшие, доставшие] меч, [мечом, им] [погибнут, встретят свою смерть].	subject
I never think of the future it comes soon enough.	Я [стараюсь, пытаюсь] не [думать, заботиться, беспокоиться] о [будущем, грядущем], ведь оно [наступит, придёт, настанет] [очень, уже] скоро.	subject
Do not anticipate trouble or worry about what may never happen. Keep in the sunlight.	Не [бойтесь, ожидайте, предвосхищайте] беду и не [бойтесь того, беспокойтесь о том, думайте о том] , что может [никогда, вообще] не случиться. Выше голову!	subject
Take time to deliberate; but when the time for action arrives, stop thinking and go in.	[Взвесьте, Обдумате, Продумайте] всё как можно [точнее, тщательнее], но когда наступит [момент, время] [реагировать, для действий], перестаньте думать и начните [действовать, делать].	subject
The mind that is anxious about future events is miserable.	Несчастлив тот [разум который, ум который, разум что, человек который],  беспокоится о [возможных, будущих, грядущих] событиях.	subject
Live in each season as it passes; breathe the air, drink the drink, taste the fruit, and resign yourself to the influences of each.	[Живи, Наслаждайся жизнью, Проживи жизнь, Распоряжайся своей жизнью] так, как тебе хочется. Дыши [воздухом, полной грудью], пей воду, [ешь, кушай] фрукты. И [наслаждайся полученными ощущениями, получай удовольствие от ощущений].	subject
I avoid looking forward or backward, and try to keep looking upward.	Я [избегаю, зарекаюсь] [заглядывать, смотреть] вперед или назад и стараюсь смотреть только [наверх, вверх].	subject
The more difficulties one has to encounter, within and without, the more significant and the higher in inspiration his life will be.	Чем больше [трудностей, препятствий, опасностей] встречает человек на [своем пути, жизненном пути], тем [больше, сильнее] он [ценить свою жизнь, дорожит своей жизнью, ощущает ценность своей жизни].	subject
I was always looking outside myself for strength and confidence, but it comes from within. It is there all of the time.	Я [всегда, всё время, постоянно, вечно] искал силы и уверенности извне, но они [всегда, всё это время] были внутри.	subject
We can do anything we want to do if we stick to it long enough.	Мы [способны, можем] достичь всего, [чего, что] только [захотим, пожелаем], если будем [идти к этому, следовать за этим] достаточно долго.	subject
Our business in life is not to get ahead of others, but to get ahead of ourselves.	[Главная, Основная, Основополагающая] наша [задача, цель] в жизни [не в том, состоит не в том, залючается не в том], чтобы [опередить, обогнать] других, а в том, чтобы опередить [самих себя, себя самих, нас самих]. 	subject
Insist on yourself. Never imitate.	Не [беспокойтесь, волнуйтесь, тревожьтесь] ни о чем, если у вас есть [смелость, мужество, решимость, решительность, сила].	subject
Who looks outside, dreams. Who looks inside, awakes.	Те, кто [смотрят, глядят] по сторонам, [могут, умеют] [лишь, только] [грезить, мечтать], но [способные, отважившиеся, рискнувшие, осмелившиеся] заглянуть внутрь себя - [просыпаются, пробуждаются].	subject
It is not easy to find happiness in ourselves, and it is not possible to find it elsewhere.	[Нелегко, Тяжело, Трудно, Непросто] найти счастье в себе, но [в другом месте, где-либо ещё] [найти, отыскать, выискать, разыскать] его [невозможно, не получится, не выйдет].	subject
The only journey is the one within.	[Важнейший, Решающий, Самый главный, Самый важный] путь человека это тот по которому он решает [продвигаться, пойти, направится] [своим сердцем, своей душой].	subject
Follow your honest convictions, and stay strong.	Следуйте своим убеждениям и [оставайтесь сильными, будьте сильными, не теряйте силы].	subject
The happiness of your life depends upon the quality of your thoughts; therefore guard accordingly.	[Ваше счастье, Ваше удача, Ваш успех] зависит от ваших мыслей, [поэтому, так что] думайте соответствующе.	subject
Action may not always bring happiness; but there is no happiness without action.	[Деятельность, Активность] не всегда [может, способна] [принести, дать, доставить, обеспечить] счастье; но [нет, не бывает] счастья без деятельности.	subject
Happiness depends more on the inward disposition of mind than on outward circumstances.	[Pадость, Счастье] в большей степени зависит от внутреннего расположения [духа, ума], чем от внешних [фактов, обстоятельств].	subject
There is no happiness except in the realization that we have accomplished something.	Нет [радости, счастья], кроме как в [осознании, понимании] того, что мы [создали что то, достигли чего-то].	subject
Happiness is not a goal, but a by-product.	[Счастье, Блаженство] – это не [цель, мечта], а [продукт, результат] [труда, деятельности, упорной работы].	subject
Happiness is not a state to arrive at, but a manner of traveling.	[Радость, Счастье, Блаженство] — это не [чувство, состояние], которого [нужно, необходимо] достичь, а способ [жизни, существования, путешествия по жизни].	subject
Purpose is what gives life a meaning.	[Цель, Назначение] – это то, что придает [жизни, существованию] [смысл, значение].	subject
The significance of a man is not in what he attains but in what he longs to attain.	[Достоинство, Значение, Важность, Ценность] человека не в том, что он [достиг, получил, приобрёл, заработал], а в том, что он [жаждет, хочет, желает, собирается, планирует] [достичь, заполучить].	subject
In all things that you do, consider the end.	[Начиная что-либо, Приступая к чему либо, Берясь за что-либо], [думайте, подумайте] о том, как [будете это заканчивать, собираетесь это заканчивать, планируете это заканчивать, как это закончится, как это может закончится].	subject
Life can be pulled by goals just as surely as it can be pushed by drives.	Жизнь поддерживается [надеждами, желаниями, грёзами], но движут ею [побуждения, изменения, стремления, устремления].	subject
The virtue lies in the struggle, not in the prize.	[Добродетельность, Достоинство, Благородство] [заключается, проявляется] в готовности к борьбе, а не в желании [награды, вознаграждения].	subject
To reach a port, we must sail, not tie at anchor	[Чтобы, Если мы хотим] добраться до [порта, гавани], [мы должны, нам нужно] плыть, а не бросать якорь. 	subject
Success is the child of audacity.	[Успех, Счастье, Удача] – это дитя [смелости, отваги, мужества].	subject
The difference between a successful person and others is not a lack of strength, not a lack of knowledge, but rather a lack in will.	[Разница, Различие] между успешным и [обычным, простым] человеком [заключается, состоит] не в недостатке силы или [знаний, знания], а скорее в недостатке воли. 	subject
The secret of success is to know something nobody else knows.	[Секрет, Тайна, Сила, Суть] успеха [заключается, находиться, содержится, лежит] в том, чтобы знать то, что [никто другой не знает, другие не знают, не знают другие].	subject
The surest way not to fail is to determine to succeed.	Самый [верный, правильный, точный, надежный] [способ, метод] не потерпеть [неудачу, провал, фиаско] — это [следовать, идти] к успеху.	subject
I cannot give you the formula for success, but I can give you the formula for failure which is: Try to please everybody."	Я не могу дать вам формулу [успеха, победы, удачи], но я могу дать вам формулу [неудачи, провала], [которая, она] заключается в следующем: [постарайтесь, попытайтесь] угодить [всем, каждому, всем и каждому].	subject
Careful thinking and hard work will solve nearly all your problems. Try and see for yourself.	Война [решает, может решить] все [проблемы, вопросы], кроме [мирных, вопросов мира].	subject
Years teach us more than books.	[Годы учат, Возраст учит, Опыт учит, Жизнь учит]  нас большему, чем [книги, то что пишут в книгах, то что написано в книгах].	subject
The only medicine for suffering, crime, and all the other woes of mankind, is wisdom.	Единственным [лекарством, средством, оберегом] от [страданий, несчастий, мучений], [преступлений, злодеяний] и всех [других, прочих] [бед, горестей] человечества является [мудрость, здравый смысл].	subject
The art of being wise is knowing what to overlook.	[Искусство быть мудрым, Таинство мудрости, Настоящая мудрость, Истинная мудрость] заключается в том, чтобы [знать, понимать, осознавать, представлять, иметь представление о том, отдавать себе отчёт в том], что [можно, нужно, допустимо] упускать из виду.	subject
The great lesson is that the sacred is in the ordinary, that it is to be found in one's daily life, in one's neighbors, friends and family, in one's backyard.	[Беден, Несчастен, Нуждается, Нищий] не тот, у кого мало, а тот, [кто хочет, кому хочется, кто желает] [большего, ещё].	subject
A wise man learns by the mistakes of others, a fool by his own.	[Интеллигентный, Мудрый] человек [получает, приобретает] знания из [исторического опыта, опыта прошлого] , а глупец - [лишь, только, исключительно] после того как сам его [повторил, воспроизвёл].	subject
No man was ever wise by chance.	[Пользуйся каждым днём, Используй каждый день], как можно меньше [полагаясь, опираясь] на [следующий, последующий].	subject
In everything the ends well defined are the secret of durable success.	В [памяти, воспоминаниях] [остаются, сохраняются] не слова врагов, а [молчание, безмолвие] друзей.	subject
Arriving at one goal is the starting point to another.	[Достижение, Выполнение, Завершение] одной цели является [отправной точкой, толчком] для [начала, старта] стремления к другой.	subject
A goal is a dream with a deadline.	[Цель, Задача] – это [мечта, желание] с дедлайном.	subject
Goals are the fuel in the furnace of achievement.	Никто не [может, способен, в состоянии] [дать тебе совет, что либо посоветовать тебе] лучше, чем ты сам. 	subject
We are what we repeatedly do. Excellence, therefore, is not an act but a habit.	[Если, Когда] зло [побеждает, одерживает победу, одерживает верх], его [объявляют, нарекают, провозглашают] добром.	subject
Take risks and you'll get the payoffs. Learn from your mistakes until you succeed. It's that simple.	[Рискуйте, Не бойтесь рисковать], и вы получите [вознаграждение, награду, воздаяние]. Учитесь на своих ошибках, пока не [добьетесь успеха, достигните успеха, придёте к успеху]. Это [так просто, так легко, элементарно, совсем не сложно].	subject
[Sadly, Unfortunately] everything is completely [self-evident, obvious, clear, straightforward].	[Увы, К сожалению] всё полностью [однозначно, очевидно, ясно, понятно].	subject
The [Principle, Concept, Idea, Notion] "an eye for an eye" will only [make the whole world blind, blind the whole world, blind everyone, lead to blindness of an entire planet].	[Принцип, Концепт, Идея, Понятие] «око за око» лишь [сделает весь мир слепым, ослепит весь мир, приведёт к слепоте мира, приведёт к слепоте целой планеты, приведёт к слепоте человечества, приведёт к слепоте всех людей].	subject
[Honesty, the Truth] is [the first, the primary, the most affected] victim of war. The [Essence, Nature] of war is [deception, lies].	 [Правда, Истина] — [первая, основная, это самая пострадавшая, главная] жертва войны. [Сущность, Натура] войны — [обман, ложь].	subject
Success is how high you bounce after you hit bottom.	Кто [чего, что] [хочет, желает], тот в [то, это] и верит.	subject
Positive thinking will let you do everything better than negative thinking will.	Позитивное мышление [позволит вам, даёт вам возможность, даст вам возможность] [сделать больше, достичь большего], чем негативное.	subject
I'm not afraid of dying, I'm afraid of not trying.	[Когда начинается война, С началом войны, Если начинается война], [вас превращают в патриотов, из вас делают патриотов].	subject
Whatever the mind can conceive and believe, the mind can achieve.	Либо [человечество, человеческое общество] [покончит с войной, положит конец войне], либо война покончит с [человечеством, людьми]. 	subject
The longer you're not taking action the more money you're losing	Чем [дольше, больше времени] вы [бездействуете, ничего не делаете] - тем больше денег [теряете, упускаете].	subject
If you live for weekends or vacations, your shit is broken	Воевать [ради, во имя] мира — [это как, всё равно что, то же самое что] трахаться ради [девственности, целомудрия].	subject
Everyone has a poet and a murderer in his soul, but it is customary to hide this.	[У каждого, У любого, У всех нас, У всех ] в душе живёт поэт и [убийца, злодей, киллер, преступник], только это принято [скрывать, прятать, утаивать].   	subject
Have the end in mind and every day make sure your working towards it	[Держите в виду свою цель, Не упускайте из виду свою цель, Не упускайте свою цель из виду] и убедитесь, что вы [каждый день, ежедневно, ежесуточно] [работаете, трудитесь] над ее [достижением, реализацией, выполнением, осуществлением].	subject
He who begins many things finishes but few	Тот, кто [берётся за множество, начинает множество] вещей - [редко, не часто] [заканчивает, завершает] [какие-либо, что-либо] из них.	subject
The best use of life is to spend it for something that outlasts it	Лучше [потратить свою жизнь на то, посвятить свою жизнь тому, отдать свою жизнь тому], что не закончится [с её завершением, после её завершения].	subject
If you think education is expensive, try ignorance	[Солдатами, Воинами, Военными] не рождаются, [солдатами, воинами, военными] умирают.	subject
To never forget that the most important thing in life is the quality of life we lead	Когда [кончаются, заканчиваются] доводы, начинают [говорить, вещать] пушки.	subject
Its better to own the racecourse then the race horse	[Лучше, Приятнее] владеть [всем, целым] ипподромом, чем  [одной скаковой лошадью, одним скакуном, одной лошадью].	subject
When you go to buy, don't show your silver	Никто не [знает, понимает. осознаёт], что такое война, [пока, до тех пор пока] не отправит туда [собственного, своего] сына.	subject
Its easier to ask forgiveness than it is to get permission	[Попробуй, Как можно, Получится ли] [спастись, спрятаться, сбежать] от дождя, если он внутри.	subject
To win without risk is to triumph without glory	[Победа, Выигрыш] без риска, что [торжество, триумф] без славы.	subject
Associate yourself with people of good quality, for it is better to be alone than in bad company	[Страйтесь, Пытайтесь, Постарайтесь, Попытайтесь] [окружить, окружать] себя [достойными, приличными] людьми, [лучше, уж лучше, предпочтительнее] быть [одним, в одиночестве], чем в [дурной компании, дурном обществе, плохой компании, скверной компании, скверном обществе].	subject
There is only one success to be able to spend your life in your own way	[Помните, Не забывайте, Имейте в виду, Знайте], что нет [тюрьмы, темницы] [страшнее, ужаснее], чем в голове.	subject
Fall seven times, stand up eight	Кто [что хочет, что желает, чего жаждает, о чём думает], тот в то и верит.	subject
Whatever the mind can conceive and believe, the mind can achieve	[Сострадание, Сочувствие, Взаимопонимание] — [основа, базис, фундамент, суть, стержень] всей морали.	subject
I have not failed. I've just found 10,000 ways that wont work	Я не потерпел [неудачу, поражение]. Я лишь [нашел, обнаружил, узнал, выявил] 10 000 способов, которые не работают.	subject
If you ain't making waves, you ain't kickin' hard enough	[Единственная, Есть лишь одна, Существует только одна] правда [в этом мире, на этом свете, на Земле] – «правды нет».	subject
What is not started will never get finished	[То что не было начато, Не начатое, То что вы не начали], не может быть [закончено, завершено, окончено].	subject
When you cease to dream you cease to live	[Когда, Как только, Если] ты [перестаешь, прекращаешь] мечтать, ты перестаешь жить.	subject
Being realistic is the most commonly traveled road to mediocrity.	[Быть, Стать] реалистом — это самый [распространенный, простой] путь к [посредственности, заурядности].	subject
If hard work is the key to success, most people would rather pick the lock.	[Мудрый, Разумный, Благоразумный] человек [всегда, в любой ситуации] [найдёт, отыщет] способ, чтобы [не начать войну, избежать войны, не начинать войну, избежать войны].	subject
Success is simply a matter of luck. Ask any failure.	Успех — это [просто, лишь, всего лишь, исключительно] вопрос [удачи, везения, фортуны]. Спросите любую неудачу.	subject
The road to success is always under construction.	Дорога к успеху [всегда, постоянно] [находится, пребывает] в стадии строительства.	subject
Anything the mind can conceive, it can achieve.	[Всегда, Постоянно, Вечно, Неизменно] [есть, найдутся, имеются] деньги для войны. Но никогда [нет, не хватает, но достаточно, не бывает] денег на мир и на людей.	subject
Most great people have attained their greatest success just one step beyond their greatest failure.	[Большинство великих людей, В основном великие люди]  [достигли, добились] своего [величайшего, самого выдающегося] успеха всего в [одном шаге, единственном шаге, за шаг] от своего [величайшего, крупнейшего] [поражения, провала].	subject
Whether you think you can or you cant, you're right.	[Человек, Каждый, Каждый из нас] [должен,  обязан] не принимать, а [выбирать, избирать, решать] свою судьбу .	subject
Failure defeats losers, failure inspires winners.	[Неудачи, Поражения] [угнетают, подавляют, удручают, повергают в уныние] неудачников, но [вдохновляют, воодушевляют] победителей.	subject
I have not failed. Ive just found 10,000 ways that wont work.	[Нет времени, Не надо тянуть время и, Не надо медлить и] оставлять [важные, самые главные] слова [невысказанными, на потом].	subject
The biggest failure you can have in life is not trying at all.	Тому, кто [способен, может, в состоянии] [укротить, обуздать] своё сердце, [покорится, подчиниться] [весь, целый] мир.	subject
I honestly think it is better to be a failure at something you love than to be a success at something you hate.	[Я искренне считаю, Лично я считаю, Лично я полагаю. Мне кажется, Мне лично кажется, Я искренне полагаю], что лучше потерпеть [неудачу, фиаско] делая, что  любишь, чем [добиться успеха, достичь успеха, прийти к успеху] в том, что  ненавидишь.	subject
Leaders don't force people to follow, they invite them on a journey.	Люди никогда не верят тому, что им [рассказывают, говорят], они должны [до всего дойти, понять всё] сами.	subject
Example is not the main thing in influencing other people; its the only thing.	Не только [главный, основной], но и единственный [способ, метод] вдохновить людей - [вдохновить их примером, показав им пример, на собственном примере, своим примером].	subject
Leadership is doing what is right when no one is watching.	[Настоящий, Истинный, Реальный, Честный] лидер делает то, что [правильно, нужно, необходимо], даже когда никто не [смотрит, видит, обращает внимания].	subject
Leadership is the art of getting someone else to do something you want done because he wants to do it.	[Лидерство, Настоящее лидерсво, Истинное лидерство] — это [искусство, мастерство, способность, умение] заставить кого-то [сделать, совершить] то, что [вы хотите, вам нужно, вам необходимо, требуется вам], чтобы он при этом думал, что [хочет этого сам, это его собственное желание, это нужно ему самому, принял это решение сам].	subject
I am more afraid of an army of one hundred sheep led by a lion than an army of one hundred lions led by a sheep.	Я [больше боюсь, скорее испугаюсь, больше страшусь, больше опасаюсь] [армии, войска] из [ста, сотни] овец во главе со львом, чем [армии, войска] из ста львов во главе с овцой.	subject
The whole problem with the world is that fools and fanatics are always so certain of themselves, but wiser people so full of doubts.	Все [беды, несчастья, трагедии] мира в том, что [дураки, глупцы] и фанатики всегда уверены [в себе, во всём], а люди поумнее [полны сомнений, испытывают сомнения, страдают от сомнений].	subject
Cannibals prefer those who have no spines.	[Перемены, Изменения, Преобразования] происходят [лишь, только] тогда, когда мы идем [против того, наперекор тому], [к чему привыкли, что нам привычно].	subject
[Kindness, Benefactor, Virtue, Dignity] is the only investment that [never fails, always pays off].	[Доброта, Благодетель, Добродетель, Достоинство] — единственное вложение, которое [никогда не подводит, всегда окупается].	subject
If one does not know to which port one is sailing, no wind is favorable.	[Если, Когда] человек не [знает, представляет], в какой порт [он плывет, ему плыть], [никакой, любой] ветер не будет попутным.	subject
You miss 100% of the shots you don't take.	[Когда, Если] мы счастливы, мы всегда добры; но когда мы добры, мы не всегда [счастливы, жизнерадостны, радостны, довольны, позитивны, оптимистичны].	subject
The vision must be followed by the venture. It is not enough to stare up the steps we must step up the stairs.	[Давайте жить, Так будем жить, Давайте проживём жизнь] так, чтобы даже гробовщик пожалел о нас, когда мы [умрём, погибнем, нас не станет]!	subject
Do not wait to strike until the iron is hot; but make it hot by striking.	Каждому нужен [кто-то, хоть кто-то, некто, кто-нибудь], кто его выслушает.	subject
Its easier to ask forgiveness than it is to get permission.	Она [всегда, постоянно, часто, то и дело] давала себе [хорошие, полезные, годные] советы, [хоть, правда] следовала им [нечасто, редко].	subject
For the [government, leadership], which [plants, sends, throws] into prison [everyone, anyone] who stumbles, the place of the [righteous, virtuous, just] person is in prison.	Для [правительства, руководства], которое [сажает, отправляет, швыряет] в тюрьму [каждого, любого] оступившегося, место [праведного, добродетельного, справедливого] человека в тюрьме.	subject
One day your life will flash before your eyes. Make sure it is worth watching.	[Однажды, Когда-нибудь, Будет время и, Наступит время и] вся жизнь [промелькнет, пробежит] [перед вашими глазами, перед вашим взором, у вас перед глазами]. [Убедитесь, Постарайтесь, Сделайте так], чтобы вам было на что [посмотреть, взглянуть].	subject
The secret of getting ahead is getting started.	[Секрет, Весь секрет, Тайна, Вся тайна] успеха [в, лишь в, только в] том, чтобы начать.	subject
If youre not making mistakes, then youre not making decisions.	Если вы не [делаете, совершаете, допускаете] ошибок, [значит, то], вы не принимаете решений.	subject
Your most unhappy customers are your greatest source of learning.	Всё можно сделать [лучше, точнее, правильнее], чем было до сих пор.	subject
Whenever you are asked if you can do a job, tell em, Certainly, I can! Then get busy and find out how to do it.	[Всякий раз, Каждый раз], когда вас спрашивают, можете ли вы выполнить [работу, задачу], [скажите, ответьте] им: «[Конечно, Разумеется, Естественно], я могу!» [Займитесь делом, Принимайтесь за дело] и узнайте, как можно это [сделать, выполнить, осуществить].	subject
Everything started as nothing.	Всё [началось, идёт, случилось] как ни в чем не бывало.  	subject
If you start with nothing and end up with nothing, theres nothing lost.	Вы начинаете с нуля и [заканчиваете, закончите] ни с чем, [поэтому, следовательно, потому, соответственно] [вы ничего не теряете, и терять вам нечего, не стоит бояться что-либо потерять].	subject
Start today, not tomorrow. If anything, you should have started yesterday.	[Начните, Начинайте, Приступайте к действиям, Действуйте] сегодня, а не завтра. [Вообще-то, На самом деле], [вы должны были, вам стоило, вам следовало] начать [уже, ещё] вчера.	subject
Make it happen now, not tomorrow. Tomorrow is a losers excuse.	[Сделайте это, Начинайте делать это, Приступайте к действиям, Начинайте действовать, Начните действовать, Действуйте] сейчас, а не завтра. Завтра - это [оправдание, отговорка] [неудачников, лузеров].	subject
ise men speak because they have something to say; fools because they have to say something.	[Разумные люди, Мудрецы, Мудрые люди] говорят, [потому что, когда им] им есть что сказать, [глупцы, простофили, дураки] потому, что они [должны что-то сказать, не могут молчать, не способны молчать].	subject
Opportunity is missed by most people because it is dressed in overalls and looks like work.	[Большинство людей, Многие люди] упускают возможность [из-за того, потому что, поскольку], она одета в комбинезон и выглядит как [работа, труд]. 	subject
Not a single person whose name is worth remembering lived a life of ease.	Ни один человек, [чье имя, которого] [стоит, следует] помнить, не жил [легкой, простой, спокойной] жизнью.	subject
If you think that you are going to love something, give it a try. Youre going to kick yourself in the butt for the rest of your life if you dont.	[Если, В том случае если] вы [думаете, считаете, предполагаете, полагаете], что вам что-то [понравится, должно понравиться] - попробуйте. Вы будете пинать себя под зад всю [оставшуюся, свою] жизнь, если [не сделаете этого, хотя бы не попытаетесь].	subject
If you want one year of prosperity, grow grain. If you want ten years of prosperity, grow trees. If you want one hundred years of prosperity, grow people.	Если вы хотите один год [процветания, благодействия, благополучия], выращивайте зерно. Если вы хотите [10 лет, десять лет] [процветания, благодействия, благополучия], [выращивайте, сажайте] деревья. Хотите [100 лет, сто лет, сотню лет] [процветания, благодействия, благополучия], выращивайте людей.	subject
Vision without action is a daydream. Action without vision is a nightmare.	Понимание без [действия, поступков, деятельности] — [это только мечта, только мечта, лишь мечта]. [Действие, Деятельность] без понимания — это [кошмар, ужас].	subject
Sow a thought, reap an action; sow an action, reap a habit; sow a habit, reap a character; sow a character, reap a destiny.	Я никогда не [беспокоясь, забочусь, тревожусь] о действии, только [о бездействии, об инертности, о пассивности].	subject
A journey of a thousand miles begins with a single step.	Путь в тысячу [миль, километров, верст] начинается с [одного, первого] шага.	subject
The loftiest towers rise from the ground.	Чем выше баншня, тем [прочнее, устойчивее, крепче] для неё [должен быть фундамент, нужен фундамент, для неё должно быть основание, нужно основание].	subject
All cats love fish but fear to wet their paws.	Все [кошки, коты] любят [рыбу, рыбку], но [боятся намочить, не любят мочить] [лапы, лапки].	subject
Dont stand by the water and long for fish; go home and weave a net.	[Не стойте, Не стоит стоять, Не следует стоять, Не простаивайте] у [воды, озера, реки] в ожидании рыбы; [идите, возвращайтесь] домой и плетите сеть. 	subject
Everyone should carefully observe which way his heart draws him, and then choose that way with all his strength.	[Каждый, Всякий] должен [чувствовать, ощущать], куда [влечет, ведёт] его сердце,и изо всех сил [стараться, пытаться, попытаться, постараться] следовать [этому пути, этим путём].	subject
Success is a lousy teacher. It seduces smart people into thinking they cant lose.	Успех — [плохой, не лучший, не самый лучший, ненадёжный] учитель. Он [соблазняет, искушает, прельщает] умных людей, [заставляя их думать, внушая им], что они [не могут, не способны] проиграть.	subject
We make a living by what we get. But we make a life by what we give.	Мы зарабатываем на жизнь тем, [что у нас есть, что имеем, что мы имеем]; но мы [создаем, творим] жизнь тем, [что отдаем, чем делимся].	subject
Believe that you will succeed and you will.	[Верьте, Поверьте, Не сомневайтесь], что у вас все получится, и [у вас все выйдет, вы всё сможете, вы добьётесь успеха, вы достигнете успеха, вы преуспеете].	subject
Victory comes only after many struggles and countless defeats.	Победа приходит [только, лишь, только лишь] после [многих, множества] сражений и [бесчисленных, многочисленных] поражений.	subject
As long as you're going to be thinking anyway, think big.	[Если уж, Коль, Раз уж] вы собрались думать, [то мыслите, то думаете, так мыслите, так думайте] [масштабно, по крупному].	subject
Success is how high you bounce after you hit bottom	[Успех, Победа, Триумф][ — это то, определяет то], как сильно [вы сможете, у вас получится] оттолкнуться, достигнув дна.	subject
Remembering you are going to die is the best way I know to avoid the trap of thinking you have something to lose.	[Помнить, Всегда помнить, Не забывать, Никогда не забывать], что ты [умрешь, смертен], — [лучший, наилучший, самый проверенный] из известных мне [способов, средств] избежать мысли, что тебе есть что терять.	subject
Its not about how to get started; its about how to get noticed.	Дело не в том, [как, с чего, каким образом] начать, а в том, чтобы сделать так, что [тебя заметили, на тебя обратили внимание].	subject
A ship in harbor is safe, but that's not what ships are for.	В гавани [корабль в безопасности, кораблю ничто не угрожает], но корабли [строят, создают] не для того, чтобы они [стояли, простаивали] в гавани.	subject
If I find 10,000 ways something wont work, I haven't failed. I am not discouraged, because every wrong attempt discarded is often a step forward.	Я не потерпел [поражения, провал, неудачу, фиаско]. Я [просто, лишь] [нашел, обнаружил, выявил] [10 000 способов, десять тысяч способов, тысячу способов], которые не работают.	subject
Every generation laughs at the old fashions, but follows religiously the new.	[Каждое поколение, Каждое новое поколение] смеется над [старой, прошлый, устаревший] модой, [неизменно, постоянно, каждый раз] следуя новой.	subject
Nothing will work unless you do.	[Ничего, Никогда ничего, Ничто, Никогда ничто] не [будет, начнёт] работать, если вы сами не [будете, начнёте] работать.	subject
Try not to be a man of success, but rather try to become a man of value.	[Старайтесь, Пытайтесь, Стремитесь, Постарайтесь] [быть, стать] не [успешным, состоятельным], а  [достойным, стоящим] человеком.	subject
You wont get anything unless you have the vision to imagine it.	Вы [ничего, никогда ничего, совершенно ничего] не [добьётесь, достигните], если у вас не хватает [воображения, фантазии] представить [желаемое, то что вы хотите].	subject
Success is doing what you want, where you want, when you want, with whom you want as much as you want.	[Успех, Удача, Победа, Результат, Триумф] — это [делать то, заниматься тем], что хочешь, где хочешь, когда хочешь, с кем хочешь, сколько хочешь.	subject
Don't be trapped by dogma which is living with the results of other peoples thinking.	[Не попадайтесь в ловушку, Не попадитесь в ловушку, Избегайте ловушки] [догмы, слепой веры], [которая живет, живущей] [результатами, итогами, следствиями] [мышления, размыщлений, помыслов] других людей.	subject
Do or do not. There is no try.	[Либо действуйте либо нет, Или действуйте или нет, Делайте или не делайте, Действуйте или не действуйте]. [Время попыток прошло, Пытаться уже поздно, Просто пытаться уже поздно, Сейчас не время для попыток]	subject
Ideas are commodity. Execution of them is not.	[Сами, Сами по себе] [идеи, планы] - это [просто, лишь, только] товар, а вот их [исполнение, реализация, претворение в жизнь] уже нет. 	subject
A pessimist sees the difficulty in every opportunity; an optimist sees the opportunity in every difficulty.	Пессимист [видит, замечает] трудность в [каждой, любой] возможности; оптимист [видит, замечает] возможность в [каждой, любой] трудности.	subject
Ideas are easy. Implementation is hard.	[Идею, План] придумать [легко, не трудно, просто]. [Реализовать, Осуществить, Воплотить в жизнь] сложнее.	subject
You can say anything to anyone, but how you say it will determine how they will react.	Вы можете [сказать, утверждать] что угодно кому угодно, но как они [отреагируют на это, воспримут это] зависит от того, [как, каким образом] вы это скажете.	subject
In between goals is a thing called life, that has to be lived and enjoyed.	Кроме [целей, задач, планов] есть одна вещь, [называемая жизнью, это жизнь, именуемая жизнью, зовущаяся жизнью], которую [нужно, надо, стоит, следует] прожить наслаждаясь.	subject
Don't worry about failure; you only have to be right once.	Не [беспокойтесь, заботьтесь] о [неудачах, поражениях]; ведь вам нужно лишь [единожды, один раз] [достичь, добиться] успеха.	subject
Your time is limited, so don't waste it living someone else's life.	Ваше время ограничено, так что не [тратьте, расходуйте, растрачивайте] его [впустую, зря, бесцельно], живя чужой жизнью.	subject
Openly share and talk to people about your idea. Use their lack of interest or doubt to fuel your motivation to make it happen.	[Открыто, Откровенно] делитесь с людьми своими [идеями, мыслями]. Используйте их отсутствие [интереса, заинтересованности] или сомнения, чтобы подпитывать вашу мотивацию, для [воплощения, реализации] их [в жизнь, на практике].	subject
How you climb a mountain is more important than reaching the top.	[Путь, Сам путь] на гору, [важнее, более важен, значимее], чем достижение вершины.	subject
Associate yourself with people of good quality, for it is better to be alone than in bad company.	[Пытайтесь, Старайтесь, Попытайтесь, Постарайтесь] общаться с [достойными, интеллигентыми, порядочными, воспитанными] людьми, [ибо, ведь] лучше уж быть одному, чем в [дурной компании, плохой компании, дурном обществе, дурной компании, глупом обществе].	subject
Its fine to celebrate success but it is more important to heed the lessons of failure.	Приятно [праздновать, отмечать] успех, но [гораздо важнее, значительно более важно] [извлечь, уметь извлечь, знать как извлечь] уроки из поражений.	subject
It takes 20 years to build a reputation and five minutes to ruin it. If you think about that, you'll do things differently.	[Требуется, Необходимо, Нужно] [20, двадцать] лет, чтобы создать репутацию, и пять минут, чтобы ее [разрушить, уничтожить]. Если вы [задумаетесь над этим, подумаете об этом, примите это], то [будете, станете] действовать [по-другому, иначе].	subject
There is only one success- to be able to spend your life in your own way.	[Есть, Существует, Имеется] [только, лишь, только лишь] один критерий успеха — [уметь, возможность] распоряжаться жизнью [по-своему, как вам хочется].	subject
When everything seems to be going against you, remember that the airplane takes off against the wind, not with it.	[Когда, Если] кажется, что все идёт [против вас, не так как вы планировали, не так как вы думали], [помните, вспомните], что самолет взлетает против ветра, а не по [нему, ветру].	subject
Rarely have I seen a situation where doing less than the other guy is a good strategy.	[Редко, Нечасто] я [видел, наблюдал] ситуацию, когда делать меньше, чем другой парень, было [хорошей, надёжной, правильной] стратегией.	subject
You miss 100 percent of the shots you don't take.	[Никогда не попадёт, Ни разу не попадёт, Не сможет попасть] в [цель, мишень] тот, кто [отказывается, не собирается, боиться, не готов, не планирует] стрелять.	subject
The best time to plant a tree was 20 years ago. The second best time is now.	[Лучшее, Cамое лучшее] время для посадки дерева было [20, двадцать] лет назад. Второе лучшее время [сейчас, это сейчас].	subject
Twenty years from now, you will be more disappointed by the things that you didn't do than by the ones you did do.	[Через, Спустя] [двадцать, 20] лет вы будете [больше, в большей степени, скорее] разочарованы не тем, что сделали, а  тем, [чего, что] не сделали.	subject
Fail often so you can succeed sooner.	Чем чаще вы терпите [неудачу, поражение], тем быстрее вы [добьётесь, достигните]  победы.	subject
When you cease to dream you cease to live.	[Когда, Если, Как только] вы [перестаёте, прекращаете] мечтать, вы [перестаёте, прекращаете] жить.	subject
Whatever the mind can conceive and believe, the mind can achieve.	Всё, что [ум, разум, интеллект] может представить и во что может поверить, [ум, разум, интеллект] может [достичь, добиться, достигнуть].	subject
The way to get started is to quit talking and begin doing.	[Чтобы, Для того чтобы] приступить к действию, [нужно, надо, необходимо] [перестать, закончить, прекратить] говорить и начать [уже, наконец, уже наконец] делать.	subject
You don't learn to walk by following rules. You learn by doing and falling over.	Вы не [научитесь, учитесь] ходить, следуя правилам. Вы учитесь, [пытаясь, пробуя] и падая.	subject
The fastest way to change yourself is to hang out with people who are already the way you want to be.	Самый [быстрый, лучший, надёжный, проверенный] способ изменить себя — [это общаться, завязать общение] с людьми, которые уже являются такими, какими вы [хотите, желаете, планируете] [быть, стать].	subject
Risk more than others think is safe. Dream more than others think is practical.	Рискуйте [больше, чаще], чем другие [считают, полагают] безопасным. Мечтайте [больше, чаще], чем другие [считают, полагают] практичным.	subject
Great spirits have always encountered violent opposition from mediocre minds.	[Великие, Выдающиеся] [часто, нередко, зачастую, много раз, постоянно] [сталкивались, встречались] с [жестоким, суровым] [противостоянием, сопротивлением] посредственных умов.	subject
The critical part of plan is getting off your butt and doing something.	[Самая важная, Наиболее важная, Основная, Главная] часть плана - поднять [свою задницу, свой зад] и сделать [что-нибудь, что-либо, хоть что-нибудь].	subject
If you cannot do great things, do small things in a great way.	Если вы [не можете, не знаете как, неспособны] делать [великие, большие] дела, делайте малые дела [великим образом,великим способом].	subject
Success is not what you have, but who you are.	Успех — это не то, что у [вас есть, вы имеете], [а, но] то, [кто вы есть, кем являетесь вы сами].	subject
Every time I took these bigger risks, the opportunity for a bigger payout was always there.	[Великими, Достойными, Приличными, Порядочными, Выдающимися] людьми не [рождаются, появляются на свет] – ими становятся.	subject
The weak can never forgive. Forgiveness is the attribute of the strong	[Слабые, Слабохарактерные, Слабовольные] никогда не прощают. [Умение, Способность] прощать — [свойство, качество, удел] сильных.	subject
The only limit to our realization of tomorrow will be our doubts of today.	Единственным ограничением нашей реализации завтрашнего дня [будут, могут стать только] наши [сегодняшние, текущие] [сомнения, опасения].	subject
Fall seven times and stand up eight.	[Семь раз упади и восемь встань, 7 раз упади и 8 раз встань, Упадите 7 раз и встаньте 8, Упадите семь раз и встаньте восемь].	subject
There's no shortage of remarkable ideas, whats missing is the will to execute them.	Нет недостатка в [замечательных, превосходных] идеях, не хватает [только, лишь, только лишь] желания их [реализовать, осуществить, воплотить в жизнь].	subject
A successful man is one who can lay a firm foundation with the bricks others have thrown at him.	[Успешный, Преуспевающий] человек — это тот, кто [может, способен, в состоянии] заложить [прочный, крепкий, устойчивый] фундамент из кирпичей, которые в него [бросили, кинули] другие.	subject
It is never too late to be what you might have been.	[Никогда не поздно, Всегда есть время, Ещё не поздно] стать тем, кем вы могли бы быть.	subject
I am not a product of my circumstances. I am a product of my decisions.	Я не [продукт, результат] обстоятельств. Я [продукт, результат] [своих решений, своего выбора].	subject
There is only one way to avoid criticism: Do nothing, say nothing, and be nothing.	[Есть, Имеется, Существует] [только, лишь] [один, один единственный, единственный] способ избежать критики: ничего не делать, ничего не говорить и быть [никем, ничем].	subject
You may be disappointed if you fail, but you are doomed if you don't try.	Вы можете [быть разочарованы, разочароваться, остаться зарочарованы] , если потерпите неудачу, но вы обречены, если [не попытаетесь, хотя бы не попытаетесь, хотя бы не постараетесь, хотя бы не попробуете, не попробуете].	subject